11111111111111111111111111111111111111111111111111111
10010000000000000000000000000000000000000000000000001
10000000000000000000000000000000000000000000000000001
10000000000000000000000000000000000000000000000000001
10000000000000000000000000000000000000000000000000001
10000000000000000000000100000000000000000000000000001
10000000000000000000001110000000000000000000000000001
10000000000000000000011011000000000000000000000000001
10000000000000000000110001100000000000000000000000001
10000000000000000000100E00100000000000000000000000001
10000000000000000000110001100000000000000000000000001
10000000000000000000010C01000000000000000000000000001
10000000000000000000001010000000000000000000000000001
10000000000000000000000000000000000000000000000000001
10000000000000000000000000000000000000000000000000001
10000000000000000000000000000000000000000000000000001
10000111000000000000000000000000000000000000011100001
10000000000000000000000000000000000000000000000000001
10000000000000000000000000000000000000000000000000001
10000000000000000000000000000000000000000000000000001
10000000000000000000000000000000000000000000000000001
10000000000000000000000000000000000000000000000000001
10000000000000000000000000000000000000000000000000001
10000000000000000000000000000000000000000000000000001
10000000000000000000000000000000000000000000000000001
10000000000000000000000P00000000000000000000000000001
10000000000000000000000000000000000000000000000000001
11111111111111111111111111111111111111111111111111111
