1111111111111
100000000C001
1011111111011
1011101011011
1P0001E100001
1111111111111