111111
1PC001
100001
101111
101E01
111111