1111111111111111111111111111111111
100000000000000C00000C000000000001
1100010000100001000010000000101011
1010010000001010001001000000101011
1P0000000C00C0000000000000000000C1
100010000000000C000001000100100011
100000000C000100010000000000000001
10010001000000000000000C0000000011
10000000000000C1010000010000000011
1100000111000001E1000000000C100001
1111111111111111111111111111111111
