1111111111111111111111111111111111
100000000000000C00000C000000000001
1100010000100M00100001000000010101
1010010000001010001001000M00010101
1P0000000C00C0000000000000000000C1
10001000000M0000C00000100010010001
100000000C000100010000000000000001
1M0010001000000000000000C000000001
10000000000000MC000000001000000001
1100000111000000E0000000000C100001
1111111111111111111111111111111111